ÉuÉçÉbÉNêî,56,,,,,,
0,0,0,0,0,0,0,0
0,0,0,0,0,0,0,0
1,7,5,6,3,2,4,1
7,5,6,3,2,4,1,7
5,6,3,2,4,1,7,5
6,3,2,4,1,7,5,6
3,2,4,1,7,5,6,3
2,4,1,7,5,6,3,2
4,1,7,5,6,3,2,4
0,0,0,0,0,0,0,0
0,0,0,0,0,0,0,0
0,0,0,0,0,0,0,0
0,0,0,0,0,0,0,0
0,0,0,0,0,0,0,0
0,0,0,0,0,0,0,0
0,0,0,0,0,0,0,0
